      #B###
# ### #   #
# # # # # #
# # # # # #
# # # # # #
#   #   # #
# ####### #
#         #
######### A 
