         B
 #### ####
    # #   
 #### ### 
    #   # 
 ## # # # 
 ###### # 
A         