      #B###
# ### ### #
# # # # # #
# # # # # #
# # # # # #
#   #   # #
# ####### #
B         #
######### A 
