##A  #
## #B#
## # #
   # #
## # #
## # #

######