 #########
 #     #B 
 # ### ## 
   # #    
 ### # ## 
 #      # 
 ######## 
     #  # 
 ### ## # 
A#        