      #B###
# ### ### #
# # # # # #
# # # # # #
# # # # # #
#   #   # #
# ####### #
#         #
######### A 
